111111111111
1P0000000011
100000000001
100000000001
1000000E0001
100000000001
111111111111